................................................................................................................................................................................................................................................................................................................................
................................................................................................................................................................................................................................................................................................................................
................................................................................................................................................................................................................................................................................................................................
................................................................................................................................................................................................................................................................................................................................
................................................................................................................................................................................................................................................................................................................................
................................................................................................................................................................................................................................................................................................................................
................................................................................................................................................................................................................................................................................................................................
................................................................................................................................................................................................................................................................................................................................
................................................................................................................................................................................................................................................................................................................................
................................................................................................................................................................................................................................................................................................................................
................................................................................................................................................................................................................................................................................................................................
................................................................................................................................................................................................................................................................................................................................
................................................................................................................................................................................................................................................................................................................................
................................................................................................................................................................................................................................................................................................................................
................................................................................................................................................................................................................................................................................................................................
................................................................................................................................................................................................................................................................................................................................
............................................................................#######################.................................................#######################.....................................................................................................................................................
.......................................................................................#.......................................................................#................................................................................................................................................................
..........................................#############################................#......................###############################..................#..........................#########################...............................................#########################.....................................
.......................................................................................#.......................................................................#............................................................................................................................................################....
..................#####################................................................#.......................................................................#............................................................#############################..........................................................#............
.......................................................................................#.......................................................................#..........................................................................#........................................................................#............
.......................................................................................#.......................................................................#..........................................................................#.........................................................############################
.......................................................................................#.......................................................................#..........................................................................#.........................................................############################
.......................................................................................#.......................................................................#..........................................................................#.........................................................##############.#.........###
.................................##########################............................#.......................................................................#..........................................................................#.........................................................##############.#.........###
..........................#################################............................#.....................................#########################################....................................................................#.........................................................##############.#.........###
...................#################################.......#######.....................#...........................###################################################...........#####....................................................#..........#######........................................##############.#.........###
...P........#################################..........................................#.................###################################################...#..........................................................................#.........................................................##############.#.........###
.....#################################.................................................#.......###################################################.............#........................................########################################################################################################################
##########################################################.........#############################################################################################################.......#########################################################################################################################################
##########################################################.........###################################################.......###################################################.......#############################################################.........#######################################.........###################
