SSSSSSSSSSSSSSSSSSSSSSSSSSSSSSSSSSSSSSSSSSSDRRRR
RSBSSSSSSSSSSSSSSSSSSSSSSSSSSSSSSSSSSSRVBRRRRRRR
RRRRBSSSSSSSSSSSSSSSSSSSSSSSSSSSSBBBSVVRRRRRRRRR
RRRRRSSSSSSSSSSSSSSSSSSSSSSSSSSSSBGBBRRRRRRGRRRR
RRRRRVBBBBBSBBBSSSSSSSSSSSSSSBBBBGVRVVRRRRVVRRRR
RRRRRRRRRRBBBBBBBSSBSSSSSSBBBBRBBVVVRVVVRVRVVRRR
RRRRRRRRRRRRBVVRBBRRBSSSBBGBBRRRRDDDDDRRDDDDRRDR
VVVVVVVVVVVVVVVVVRRRRBBBBVVVRRRRRRRRRRRRRRRRRRRR
RRRDRRRRDRRDDRRRRRRRRRBBBRRRRRRRRRRSSSSRRRRRRRRR
RRRRRRRRRRRRRRRRRRRRRRRGVVRRVVRVRRRBBSBRRRRRRRRR
RRRRRRRRRRRRRGGGRRRRRBVRRRRRRRRRRVGVRVRRRRRRRRRR
RRRRRRRRRRRRRRRVVVRVRRRDDRDDDDDRRVVRVBRBVVVVRVRR
RRRRRRRRRRRRRRRRGVVGGVGRRRRRRRRRVGGVGRRRRRRRRRRR
RRRRRRRRRRRRRRRRRVRRVRRRRVBRRRBRRRVVDDRRRDDRRDDR
VRVRRRRRRRRRVRRRRBVVGGGGGGGGVVGVVVVRRRRRRRRRRRRR
RRBRBRRRRRRRDRVRRVVRRRVRVRRVRRRVVRRRRRRRRRRRRRRR
RRDDDDDDDDDDDDRDDDDDRRRRRRRRRRRRRRRRRRRRRRRRRRRR
RRRRRRRRRRRRRRRRRRRRRRRRRRRRRRRRRRRRRRRRRRRRRRRR
RRRRRRRRRRRRRRRRRRRRRDRRBBBBRRVGVGGVVVGVVVVVVVVV
RRRRRRRRRRRRRRRRRRRRRRRRSSSSBDDDRDDRDRRRRRRRRRRR
RRRRRRRVRVRRRRRRRRRRRRRRSSSSRRRDDDDRDDDDDRRRDRDR
RRRRRRRRRRRRRRRRRRRRRRRRSSSSRRRRRRRRRRRRRRRRRRRR
RRVVRVVVRRRVVGBVVVRVGVRVBSSSRRRRRRRRRRRRRRRRRRRR
RRRRRRRRRRRRRRRVRRRRDBDRRSSSRRRRRRRRRRRRRRRRRRRR
RRDRDDRDRDRDDDDDDDRDDDDRRWWWWRRRRRRRRRRRRVRRRRRR
RRDRRRRDRRDRRRRRRRRRRRRWWWWWWRRRRGGVBRRRVRRRRRRR
RBRRRRRRRRRRRRRRRRRRRRRWWWWWWRRVBRVVRVVRRVRRRRRR
RRRRRDRBRRRRRRRRRRRRRRRWWWWWWRDDDDDDDDDRRDDRRRRR
RRRRRRRRRRRRRBRRWWWWWWWWWWWWWWRRRRRRRRRRRRRRRRRR
RRRRRRRRRRRBRRDDRWWWWWWWWWWWWWRRRRRRRRRDRRRRRRRR
RRRRRRRRRRRRRRRRRWWWWWWWWWWWWWWWWRDRDRRRRRRRRRRR
RRRRRRRRRRRRRRRRRRRWWWWWWWWWWWWWWRRRRDRRRRRRRRRR
