................................................................
................................................................
............................................................E...
....................####........................................
..............###......................####.....................
..................................#####.........................
.....####.......................................................
............................####............................####
.........................####...................................
...........####.................................................
..P.............................................................
###########....................######...............#####.......
..........................#####................#####............
...............#####............................................
................................................................
################################################################
