................................................................
................................................................
..............................................####..............
....................####........................................
..............###...............................................
..................................#####.........................
.....####.......................................................
............................####............................####
.........................####...................................
...........####................................................E
..P.............................................................
###########....................######...............#####.......
..........................#####................#####............
...............#####............................................
................................................................
################################################################
