................................................................
................................................................
................................................................
................................................................
...............###..............................................
.........................####...................................
.....####.......................................................
.................................#####..........................
.................###............................................
..........................................#####.................
..P.............................................................
############.............#####....................####..........
....................####..............####......................
.........####...........................................E.......
................................................................
################################################################
