####################
#..................#
#..P...............#
#...............E..#
#..................#
####################
