####################
#P.....########....#
#.###..#......#....#
#...#..#.####.#.####
###.#......#..#....#
#...######.#..####E#
####################
