####################
#P.................#
##################.#
#.................##
#.##################
#.................##
#################.##
#.................##
#.##################
#.................##
#################.##
#.................##
#.##################
#.................##
#################.##
#.................##
#.##################
#.................##
##################E#
####################
